2,2,2,2,2,2,2,2,2,2,0,0,0,0,0,0,0,0,0,0,0,0,0,0,0,0,0,2,2,2,2,2,2,2,2,2,2
2,2,2,2,2,2,2,2,2,2,0,0,0,0,0,0,0,0,0,0,0,0,0,0,0,0,0,2,2,2,2,2,2,2,2,2,2
2,2,2,2,2,2,2,2,2,2,0,0,0,0,0,0,0,0,3,0,0,0,0,0,0,0,0,2,2,2,2,2,2,2,2,2,2
2,2,2,2,2,2,2,2,2,2,0,0,0,0,0,0,0,0,3,0,0,0,0,0,0,0,0,2,2,2,2,2,2,2,2,2,2
2,2,2,2,0,0,0,0,7,1,0,0,0,0,0,0,0,0,3,0,0,0,0,0,0,0,0,1,6,0,0,0,0,2,2,2,2
2,2,2,2,0,2,3,2,2,2,2,2,6,6,0,0,0,0,3,0,0,0,0,7,7,2,2,2,2,2,3,2,0,2,2,2,2
2,2,2,2,0,3,0,0,0,0,0,0,0,6,0,0,0,0,3,0,0,0,0,7,0,0,0,0,0,0,0,3,0,2,2,2,2
2,2,2,2,0,2,0,0,0,0,2,2,0,2,0,0,0,0,0,0,0,0,0,2,0,2,2,0,0,0,0,2,0,2,2,2,2
2,2,2,2,7,2,0,0,4,0,4,2,0,2,0,0,0,0,0,0,0,0,0,2,0,2,5,0,5,0,0,2,6,2,2,2,2
2,2,2,2,1,2,0,0,0,0,0,0,0,2,2,2,2,1,1,1,2,2,2,2,0,0,0,0,0,0,0,2,1,2,2,2,2
0,0,0,0,0,2,0,2,4,0,4,2,0,2,0,0,0,0,0,0,0,0,0,2,0,2,5,0,5,2,0,2,0,0,0,0,0
0,0,0,0,0,2,0,2,2,0,2,2,0,2,0,0,0,0,0,0,0,0,0,2,0,2,2,0,2,2,0,2,0,0,0,0,0
0,0,0,0,0,6,0,0,0,0,0,0,0,6,0,0,0,0,2,0,0,0,0,7,0,0,0,0,0,0,0,7,0,0,0,0,0
0,0,0,0,0,6,6,2,2,2,2,2,6,6,0,0,0,0,2,0,0,0,0,7,7,2,2,2,2,2,7,7,0,0,0,0,0
0,0,0,0,0,0,0,0,0,2,0,0,0,0,0,0,0,0,2,0,0,0,0,0,0,0,0,2,0,0,0,0,0,0,0,0,0
0,0,0,0,0,0,0,0,0,2,0,0,0,0,0,0,0,0,0,0,0,0,0,0,0,0,0,2,0,0,0,0,0,0,0,0,0
0,0,0,0,0,0,0,0,0,2,0,0,0,0,0,0,0,0,0,0,0,0,0,0,0,0,0,2,0,0,0,0,0,0,0,0,0
0,0,0,0,0,0,0,0,0,1,0,0,0,0,0,0,0,0,3,0,0,0,0,0,0,0,0,1,0,0,0,0,0,0,0,0,0
0,0,3,3,3,3,3,0,0,1,0,0,2,2,2,0,0,3,0,3,0,0,2,2,2,0,0,1,0,0,3,3,3,3,3,0,0
0,0,0,0,0,0,0,0,0,1,0,0,0,0,0,0,0,0,3,0,0,0,0,0,0,0,0,1,0,0,0,0,0,0,0,0,0
0,0,0,0,0,0,0,0,0,2,0,0,0,0,0,0,0,0,0,0,0,0,0,0,0,0,0,2,0,0,0,0,0,0,0,0,0
0,0,0,0,0,0,0,0,0,2,0,0,0,0,0,0,0,0,0,0,0,0,0,0,0,0,0,2,0,0,0,0,0,0,0,0,0
0,0,0,0,0,0,0,0,0,2,0,0,0,0,0,0,0,0,2,0,0,0,0,0,0,0,0,2,0,0,0,0,0,0,0,0,0
0,0,0,0,0,7,7,2,2,2,2,2,7,7,0,0,0,0,2,0,0,0,0,6,6,2,2,2,2,2,6,6,0,0,0,0,0
0,0,0,0,0,7,0,0,0,0,0,0,0,7,0,0,0,0,2,0,0,0,0,6,0,0,0,0,0,0,0,6,0,0,0,0,0
0,0,0,0,0,2,0,2,2,0,2,2,0,2,0,0,0,0,0,0,0,0,0,2,0,2,2,0,2,2,0,2,0,0,0,0,0
0,0,0,0,0,2,0,2,5,0,5,2,0,2,0,0,0,0,0,0,0,0,0,2,0,2,4,0,4,2,0,2,0,0,0,0,0
2,2,2,2,1,2,0,0,0,0,0,0,0,2,2,2,2,1,1,1,2,2,2,2,0,0,0,0,0,0,0,2,1,2,2,2,2
2,2,2,2,6,2,0,0,5,0,5,2,0,2,0,0,0,0,0,0,0,0,0,2,0,2,4,0,4,0,0,2,7,2,2,2,2
2,2,2,2,0,2,0,0,0,0,2,2,0,2,0,0,0,0,0,0,0,0,0,2,0,2,2,0,0,0,0,2,0,2,2,2,2
2,2,2,2,0,3,0,0,0,0,0,0,0,7,0,0,0,0,3,0,0,0,0,6,0,0,0,0,0,0,0,3,0,2,2,2,2
2,2,2,2,0,2,3,2,2,2,2,2,7,7,0,0,0,0,3,0,0,0,0,6,6,2,2,2,2,2,3,2,0,2,2,2,2
2,2,2,2,0,0,0,0,6,1,0,0,0,0,0,0,0,0,3,0,0,0,0,0,0,0,0,1,7,0,0,0,0,2,2,2,2
2,2,2,2,2,2,2,2,2,2,0,0,0,0,0,0,0,0,3,0,0,0,0,0,0,0,0,2,2,2,2,2,2,2,2,2,2
2,2,2,2,2,2,2,2,2,2,0,0,0,0,0,0,0,0,3,0,0,0,0,0,0,0,0,2,2,2,2,2,2,2,2,2,2
2,2,2,2,2,2,2,2,2,2,0,0,0,0,0,0,0,0,0,0,0,0,0,0,0,0,0,2,2,2,2,2,2,2,2,2,2
2,2,2,2,2,2,2,2,2,2,0,0,0,0,0,0,0,0,0,0,0,0,0,0,0,0,0,2,2,2,2,2,2,2,2,2,2
