2,2,2,2,2,2,2,2,2,2,2,2,2,2,2,2,2,2,2,2,2,2,2,2,2,2,2,2,2,2,2,2,2,2,2,2,2,2,2,2,2,2,2,2,2,2,5,5,5,5
2,4,4,0,0,0,0,0,0,2,0,0,0,0,0,0,0,0,0,0,0,0,0,1,0,0,0,0,0,0,0,0,0,0,0,0,0,7,0,0,0,0,0,0,0,0,5,5,5,5
2,4,4,0,0,0,0,0,0,2,0,0,0,0,0,0,0,0,0,0,0,0,0,1,0,0,0,0,0,0,0,0,0,0,0,0,0,7,0,0,0,0,0,0,0,0,5,5,5,5
2,0,0,2,2,2,2,6,6,2,0,0,2,2,2,2,0,0,2,2,2,2,2,2,1,1,2,2,2,2,2,2,1,1,2,2,2,2,2,2,2,2,2,2,1,1,5,5,5,5
2,0,0,2,0,0,2,0,0,0,0,0,2,0,0,0,0,0,2,0,0,0,0,2,1,1,2,0,0,0,0,0,0,0,0,0,0,2,2,2,2,2,2,2,1,1,2,0,0,2
2,0,0,6,0,0,2,0,0,0,0,0,2,0,0,0,0,0,2,0,0,0,0,2,0,0,2,0,0,0,0,0,0,0,0,0,0,2,2,2,2,2,2,2,0,0,2,0,0,2
2,0,0,6,0,0,2,2,2,2,2,2,2,0,0,0,0,0,0,0,0,0,0,2,0,0,2,0,0,0,0,0,0,0,0,0,0,2,0,0,7,0,0,0,0,0,2,0,0,2
2,2,2,2,0,0,2,0,0,0,0,0,0,0,0,0,0,0,0,0,0,0,0,2,1,1,2,0,0,0,0,0,0,0,0,0,0,2,0,0,7,0,0,0,0,0,2,0,0,2
2,5,0,2,0,0,2,0,0,0,0,0,0,0,0,0,0,0,1,1,1,0,0,2,1,1,2,2,2,2,2,3,3,3,2,2,2,2,0,0,2,2,2,2,2,2,2,0,0,2
2,0,0,2,0,0,2,0,0,0,2,0,0,2,2,2,2,2,2,2,1,0,0,2,0,0,1,1,0,0,0,0,0,0,0,0,0,0,0,0,0,0,0,0,0,0,7,0,0,2
2,0,0,7,0,0,2,0,0,0,2,0,0,2,0,0,0,0,0,2,1,0,0,2,0,0,1,1,0,0,0,0,0,0,0,0,0,0,0,0,0,0,0,0,0,0,7,0,0,2
2,0,0,7,0,0,2,0,0,0,2,0,0,2,0,0,0,0,0,2,1,0,0,2,1,1,2,2,2,2,2,2,2,2,2,2,2,2,2,2,2,2,2,0,0,2,2,2,2,2
2,0,0,2,0,0,2,2,2,2,2,0,0,2,0,0,0,0,0,2,0,0,0,2,1,1,2,0,0,0,0,0,0,0,0,0,1,0,0,1,0,0,1,0,0,2,0,0,4,2
2,0,0,2,0,0,0,0,0,0,0,0,0,2,0,0,0,0,0,2,0,0,0,3,0,0,3,0,0,0,0,0,0,0,0,0,1,0,0,1,0,0,1,0,0,2,0,0,0,2
2,0,0,2,0,0,0,0,0,0,0,0,0,2,0,0,0,0,2,2,0,0,0,3,0,0,3,0,0,0,0,0,0,0,0,0,1,0,0,2,0,0,1,0,0,2,0,0,0,2
2,2,2,2,0,0,2,2,2,2,2,2,2,2,0,0,0,0,2,0,0,0,0,2,1,1,2,0,0,0,0,0,0,0,0,0,1,0,0,2,0,0,1,0,0,2,0,0,0,2
2,0,0,0,0,0,3,0,0,0,0,0,0,0,0,0,0,0,2,0,0,0,0,2,1,1,2,0,0,0,0,0,1,1,1,1,1,0,0,2,0,0,0,0,0,2,0,0,0,2
2,0,0,0,0,0,3,0,0,0,0,0,0,0,0,0,2,2,2,0,0,0,0,2,0,0,2,0,0,0,0,0,0,0,0,0,0,0,0,2,0,0,0,0,0,2,2,0,0,2
2,0,0,0,0,0,3,0,0,0,0,0,0,0,0,0,0,0,0,0,0,0,0,2,0,0,2,0,0,0,0,0,0,0,0,0,0,0,0,2,0,0,1,0,0,6,0,0,0,2
2,0,0,0,0,0,1,0,0,0,0,0,0,0,0,0,0,0,0,0,0,0,0,2,1,1,2,0,0,0,0,0,0,0,0,0,0,0,0,2,0,0,1,0,0,6,0,0,0,2
2,0,0,0,0,0,1,0,0,0,0,0,0,0,0,0,0,0,2,2,2,2,2,2,1,1,2,2,2,2,2,2,0,0,0,0,0,0,0,2,0,0,1,0,0,2,2,2,2,2
2,2,2,2,2,2,2,2,0,0,2,2,2,2,2,2,0,0,2,4,0,0,0,0,0,0,0,0,0,0,0,2,0,0,0,0,0,0,0,2,0,0,1,0,0,0,0,0,0,2
2,0,0,0,0,0,1,0,0,0,2,0,0,0,0,2,0,0,2,0,0,0,0,0,0,0,0,0,0,0,0,2,0,0,0,0,0,0,0,2,0,0,1,0,0,0,0,0,0,2
2,0,0,0,0,0,1,0,0,0,2,0,0,0,0,2,0,0,2,0,0,0,0,0,0,0,0,0,0,0,0,2,2,0,0,2,2,2,2,2,1,1,2,2,2,2,2,0,0,2
2,0,0,2,2,2,2,2,0,0,0,0,0,0,0,0,0,0,0,0,0,0,0,0,0,0,0,0,0,0,0,0,0,0,0,0,0,0,0,0,0,0,0,0,0,0,3,0,0,2
2,0,0,2,2,2,2,2,0,0,0,0,0,0,0,0,0,0,0,0,0,0,0,0,0,0,0,0,0,0,0,0,0,0,0,0,0,0,0,0,0,0,0,0,0,0,3,0,0,2
2,0,0,2,2,2,2,2,2,2,2,2,2,0,0,2,2,2,2,0,0,0,0,0,0,0,0,0,0,0,0,2,2,2,2,2,2,2,2,0,0,0,0,0,0,0,3,0,0,2
2,0,0,2,0,0,0,0,0,0,0,0,2,0,0,0,0,0,2,0,0,0,0,0,0,0,0,0,0,0,0,2,0,0,0,0,0,0,2,0,0,0,0,0,0,0,3,0,0,2
2,0,0,2,0,0,0,0,0,0,0,0,2,0,0,0,0,0,2,0,0,0,0,0,0,0,0,0,0,0,5,2,0,0,0,0,0,0,2,0,0,0,0,0,0,0,1,0,0,2
2,0,0,2,0,0,0,0,0,0,0,0,2,2,2,2,0,0,2,2,2,2,2,2,1,1,2,2,2,2,2,2,0,0,0,0,0,0,2,0,0,0,0,0,0,0,1,0,0,2
2,0,0,2,2,2,2,2,2,2,0,0,2,0,0,2,0,0,0,0,0,0,0,2,1,1,2,0,0,0,0,0,0,0,0,0,0,0,2,2,2,0,0,2,2,2,2,2,2,2
2,0,0,0,0,0,0,0,0,0,0,0,2,0,0,2,0,0,0,0,0,0,0,2,0,0,2,0,0,0,0,0,0,0,0,0,0,0,0,0,0,0,0,0,0,0,0,0,0,2
2,0,0,0,0,0,0,0,0,0,0,0,2,0,0,2,2,2,2,2,0,0,0,2,0,0,2,0,0,1,1,1,1,1,1,0,0,0,0,0,0,0,0,0,0,0,0,0,0,2
2,0,0,2,2,2,2,2,2,2,0,0,2,0,0,0,0,0,0,2,0,0,0,2,1,1,2,0,0,1,0,0,0,0,0,0,0,2,2,2,2,2,2,2,2,2,2,0,0,2
2,0,0,2,0,0,0,0,0,2,0,0,2,0,0,0,0,0,0,2,0,0,0,2,1,1,2,1,1,1,0,0,0,0,0,0,0,2,0,0,0,0,0,0,0,0,2,0,0,2
2,0,0,2,0,0,0,0,0,2,0,0,2,0,0,1,0,0,0,0,0,0,0,3,0,0,3,0,0,0,0,0,0,0,0,0,0,2,0,0,0,0,0,0,0,0,2,0,0,2
2,0,0,0,0,0,0,0,0,0,0,0,0,0,0,0,0,0,0,0,0,0,0,3,0,0,3,0,0,0,0,0,0,0,0,0,0,2,0,0,1,1,1,1,0,0,2,0,0,2
2,0,0,0,0,0,0,0,0,0,0,0,0,0,0,0,0,0,1,1,1,0,0,2,1,1,2,0,0,0,2,2,2,2,2,2,2,2,0,0,1,0,0,0,0,0,2,0,0,2
2,2,2,2,0,0,0,0,0,2,2,2,2,2,2,2,0,0,1,1,1,0,0,2,1,1,2,0,0,2,2,0,0,0,0,0,0,0,0,0,1,0,0,0,0,0,2,0,0,2
2,0,0,6,0,0,0,0,0,2,0,0,0,0,0,2,0,0,0,0,0,0,0,2,0,0,2,0,0,0,0,0,0,0,0,0,0,0,0,0,2,0,0,2,2,2,2,0,0,2
2,0,0,6,0,0,0,0,0,2,0,0,0,0,0,2,0,0,0,0,0,0,0,2,0,0,2,0,0,0,0,0,0,0,2,2,2,3,3,3,2,0,0,2,0,0,0,0,0,2
2,0,0,2,2,2,2,2,2,2,0,0,1,0,0,2,2,0,0,0,2,2,2,2,1,1,2,0,0,0,0,0,0,0,2,0,0,0,0,0,0,0,0,2,0,0,0,0,0,2
2,0,0,2,0,0,0,0,0,6,0,0,1,0,0,0,0,0,0,0,0,0,0,1,1,1,2,0,0,0,0,0,0,0,2,0,0,0,0,0,0,0,0,2,0,0,2,2,2,2
2,0,0,2,0,0,0,0,0,6,0,0,1,0,0,0,0,0,0,0,0,0,0,1,0,0,2,0,0,0,0,2,2,2,2,0,0,2,2,2,2,2,2,2,0,0,7,0,0,2
2,0,0,2,0,0,2,2,2,2,2,2,2,2,2,2,2,2,2,2,2,2,2,2,0,0,2,0,0,0,0,2,0,0,0,0,0,2,0,0,0,0,0,2,0,0,7,0,0,2
2,0,0,2,1,1,2,2,2,2,2,2,2,0,0,0,0,0,0,0,0,0,0,2,1,1,2,0,0,0,0,2,0,0,0,0,0,2,0,0,0,0,0,2,0,0,2,0,0,2
4,4,4,4,1,1,2,2,2,2,2,2,2,0,0,0,0,0,0,0,0,0,0,2,1,1,2,2,2,2,2,2,0,0,2,2,2,2,0,0,2,7,7,2,2,2,2,0,0,2
4,4,4,4,0,0,0,0,0,0,0,0,6,0,0,0,0,0,0,0,0,0,0,0,0,0,0,0,0,0,0,0,0,0,0,0,0,0,0,0,2,0,0,0,0,0,0,5,5,2
4,4,4,4,0,0,0,0,0,0,0,0,6,0,0,0,0,0,0,0,0,0,0,0,0,0,0,0,0,0,0,0,0,0,0,0,0,0,0,0,2,0,0,0,0,0,0,5,5,2
4,4,4,4,2,2,2,2,2,2,2,2,2,2,2,2,2,2,2,2,2,2,2,2,2,2,2,2,2,2,2,2,2,2,2,2,2,2,2,2,2,2,2,2,2,2,2,2,2,2
